1111111
1.P...1
1.....1
1..U..1
1.....1
1..C..1
1111111
